10.ox
o...oo.ooo
.oo.ooo.o.
o...o.oo..
..oo.o...o
.o.o....o.
oo..oo..oo
o..ooo.o.o
ooo..o.o..
.oo..o.oo.
o.oo.o..o.
